derp
An Interactive Fiction by Dr. Mike Stedman and Sir Scott Hilbert, Esq.
Release 1 / Serial number 121128 / Inform 7 build 6G60 (I6/v6.32 lib 6/12N) SD

10 yard line
The sun blinds your eyes as you look down the ol" football pitch.

I beg your pardon?

* * *

derp
An Interactive Fiction by Dr. Mike Stedman and Sir Scott Hilbert, Esq.
Release 1 / Serial number 121128 / Inform 7 build 6G60 (I6/v6.32 lib 6/12N) SD

10 yard line
The sun blinds your eyes as you look down the ol" football pitch.

>s
20 yard line
You feel as if you are getting further away from your goal.

>s
You can't go that way.

>n
10 yard line
The sun blinds your eyes as you look down the ol" football pitch.

* * *

>s
20 yard line
You feel as if you are getting further away from your goal.

>n
10 yard line
The sun blinds your eyes as you look down the ol" football pitch.

>look
10 yard line
The sun blinds your eyes as you look down the ol" football pitch.

>exits
That's not a verb I recognise.

>s
20 yard line
You feel as if you are getting further away from your goal.

* * *

derp
An Interactive Fiction by Dr. Mike Stedman and Sir Scott Hilbert, Esq.
Release 1 / Serial number 121128 / Inform 7 build 6G60 (I6/v6.32 lib 6/12N) SD

10 yard line
The sun blinds your eyes as you look down the ol" football pitch.

>look
10 yard line
The sun blinds your eyes as you look down the ol" football pitch.

>go 20
You can't see any such thing.

>n
You can't go that way.