derp
An Interactive Fiction by Dr. Mike Stedman and Sir Scott Hilbert, Esq.
Release 1 / Serial number 121128 / Inform 7 build 6G60 (I6/v6.32 lib 6/12N) SD

Men's restroom
God it stinks like piss in here.

You can see an urinal (in which is an urinal cake) here.

>exits
That's not a verb I recognise.

* * *

derp
An Interactive Fiction by Dr. Mike Stedman and Sir Scott Hilbert, Esq.
Release 1 / Serial number 121128 / Inform 7 build 6G60 (I6/v6.32 lib 6/12N) SD

Men's restroom
God it stinks like piss in here.

You can see an urinal (in which is an urinal cake) here.

>lick cake
No, you have to save it for later.

>lick urinal
(the urinal)
Jesus Christ.

* * *

derp
An Interactive Fiction by Dr. Mike Stedman and Sir Scott Hilbert, Esq.
Release 1 / Serial number 121128 / Inform 7 build 6G60 (I6/v6.32 lib 6/12N) SD

Men's restroom
God it stinks like piss in here.

You can see an urinal (in which is an urinal cake) here.

>take urinal
That's fixed in place.

* * *

derp
An Interactive Fiction by Dr. Mike Stedman and Sir Scott Hilbert, Esq.
Release 1 / Serial number 121128 / Inform 7 build 6G60 (I6/v6.32 lib 6/12N) SD

Men's restroom
God it stinks like piss in here.

You can see an urinal (in which is an urinal cake) here.

>look cake
This isn't exactly what you had in mind when your birthday started.

>look urinal
(the urinal)
This urinal is cracked porcelain, stained yellow. The janitorial staff has a lot to answer for.

In the urinal is an urinal cake.

* * *

derp
An Interactive Fiction by Dr. Mike Stedman and Sir Scott Hilbert, Esq.
Release 1 / Serial number 121128 / Inform 7 build 6G60 (I6/v6.32 lib 6/12N) SD

Men's restroom
God it stinks like piss in here.

You can see an urinal (in which is an urinal cake) here.

>take cake
Taken.

* * *

derp
An Interactive Fiction by Dr. Mike Stedman and Sir Scott Hilbert, Esq.
Release 1 / Serial number 121128 / Inform 7 build 6G60 (I6/v6.32 lib 6/12N) SD

Men's restroom
God it stinks like piss in here.

You can see an urinal (in which is an urinal cake) here.

>eat cake
(first taking the urinal cake)
It looks edible, but you should save it for later.

* * *

derp
An Interactive Fiction by Dr. Mike Stedman and Sir Scott Hilbert, Esq.
Release 1 / Serial number 121128 / Inform 7 build 6G60 (I6/v6.32 lib 6/12N) SD

Men's restroom
God it stinks like piss in here.

You can see an urinal (in which is an urinal cake) here.

>look
Men's restroom
God it stinks like piss in here.

>look urinal
You can't see any such thing.

>n
Hallway
Hospital green, with plenty of tile.

>n
Women's restroom
How the fuck do they have a couch?!

>s
Hallway
Hospital green, with plenty of tile.

>s
Men's restroom
God it stinks like piss in here.

* * *

>look urinal
You can't see any such thing.

>look
Men's restroom
God it stinks like piss in here.

>s
You can't go that way.

>s
You can't go that way.

>n
Hallway
Hospital green, with plenty of tile.

* * *

>n
Women's restroom
How the fuck do they have a couch?!

>look
Women's restroom
How the fuck do they have a couch?!

>s
Hallway
Hospital green, with plenty of tile.

>look urinal
You can't see any such thing.

>s
Men's restroom
God it stinks like piss in here.

>n
Hallway
Hospital green, with plenty of tile.

* * *

>n
Women's restroom
How the fuck do they have a couch?!

>look urinal
You can't see any such thing.

* * *

>look
Men's restroom
God it stinks like piss in here.

>look toilet
You can't see any such thing.

>look urinal
You can't see any such thing.

* * *

>n
Hallway
Hospital green, with plenty of tile.

>look
Hallway
Hospital green, with plenty of tile.

>look urinal
You can't see any such thing.

* * *

derp
An Interactive Fiction by Dr. Mike Stedman and Sir Scott Hilbert, Esq.
Release 1 / Serial number 121128 / Inform 7 build 6G60 (I6/v6.32 lib 6/12N) SD

Men's restroom
God it stinks like piss in here.

You can see an urinal (in which is an urinal cake) here.

>s
You can't go that way.

>n
Hallway
Hospital green, with plenty of tile.

You can see a water fountain (on which is a button) here.

>take water
That's fixed in place.

>n
Women's restroom
How the fuck do they have a couch?!

You can see a toilet here.

>take toil
You can't see any such thing.

* * *

>n
Hallway
Hospital green, with plenty of tile.

You can see a water fountain (on which is a button) here.

>n
Women's restroom
How the fuck do they have a couch?!

You can see a toilet here.

>ls
That's not a verb I recognise.

>s
Hallway
Hospital green, with plenty of tile.

You can see a water fountain (on which is a button) here.

>push button
Water trickles out of the fountain and you greedily lap it up.

It is fixed in place.

* * *

>n
Women's restroom
How the fuck do they have a couch?!

You can see a toilet here.

>lick couch
You are some kind of pervert, aren't you?

* * *

>n
Hallway
Hospital green, with plenty of tile.

You can see a water fountain (on which is a button) here.

>lick fountain
You lap at the fountain but water doesn't come out.

>n
Women's restroom
How the fuck do they have a couch?!

You can see a toilet here.

>lick toilet
Jesus Christ.

>lick couch
You are some kind of pervert, aren't you?

>lick tree
You can't see any such thing.

>lick
(the toilet)
Jesus Christ.

* * *

>n
Hallway
Hospital green, with plenty of tile.

You can see a water fountain (on which is a button) here.

>look fountain
Moulded hard-touch plastic envelopes the brushed-steel body of the fountain. It stands proud and gleaming in the dirty hall.

On the water fountain is a button.

>look button
Beautiful brushed steel, you dream one day of being able to own a device with a similar button.

>push button
Water trickles out of the fountain and you greedily lap it up.

It is fixed in place.

* * *

>n
Hallway
Hospital green, with plenty of tile.

You can see a water fountain (on which is a button) here.

>push button
It is fixed in place.

* * *

>n
Women's restroom
How the fuck do they have a couch?!

You can see a toilet here.

>s
Hallway
Hospital green, with plenty of tile.

You can see a water fountain here.

>s
Men's restroom
God it stinks like piss in here.

You can see an urinal here.

>n
Hallway
Hospital green, with plenty of tile.

You can see a water fountain here.

>n
Women's restroom
How the fuck do they have a couch?!

You can see a toilet here.

>push button
You can't see any such thing.

>n
You can't go that way.

>s
Hallway
Hospital green, with plenty of tile.

You can see a water fountain (on which is a button) here.

>push button
Water trickles out of the fountain and you greedily lap it up.

* * *

>n
Women's restroom
How the fuck do they have a couch?!

You can see a toilet here.

>look couch
You see nothing special about the leather couch.

* * *

derp
An Interactive Fiction by Dr. Mike Stedman and Sir Scott Hilbert, Esq.
Release 1 / Serial number 121128 / Inform 7 build 6G60 (I6/v6.32 lib 6/12N) SD

Men's restroom
God it stinks like piss in here.

You can see an urinal (in which is an urinal cake) here.

>look urinal
(the urinal)
This urinal is cracked porcelain, stained yellow. The janitorial staff has a lot to answer for.

In the urinal is an urinal cake.

>look urinal
(the urinal)
This urinal is cracked porcelain, stained yellow. The janitorial staff has a lot to answer for.

In the urinal is an urinal cake.

>look cake
You see nothing special about the urinal cake.

* * *

>look urinal
(the urinal)
This urinal is cracked porcelain, stained yellow. The janitorial staff has a lot to answer for.

In the urinal is an urinal cake.

>s
You can't go that way.

>n
Hallway
Hospital green, with plenty of tile.

You can see a water fountain here.

* * *

>n
Women's restroom
How the fuck do they have a couch?!

You can see a toilet here.

>look couch
Black leather, surprisingly less stained than you would expect.